AB	Arab Satellite Communications Organization
ABS	Asia Broadcast Satellite
AC	Asia Satellite Telecommunications Company (ASIASAT)
ALG	Algeria
ANG	Angola
ARGN	Argentina
ASRA	Austria
AUS	Australia
AZER	Azerbaijan
BEL	Belgium
BELA	Belarus
BERM	Bermuda
BGD	Peoples Republic of Bangladesh
BHUT	Kingdom of Bhutan
BOL	Bolivia
BRAZ	Brazil
BUL	Bulgaria
CA	Canada
CHBZ	China/Brazil
CHLE	Chile
CIS	Commonwealth of Independent States (former USSR)
COL	Colombia
CRI	Republic of Costa Rica
CZCH	Czech Republic (former Czechoslovakia)
DEN	Denmark
ECU	Ecuador
EGYP	Egypt
ESA	European Space Agency
ESRO	European Space Research Organization
EST	Estonia
EUME	European Organization for the Exploitation of Meteorological Satellites (EUMETSAT)
EUTE	European Telecommunications Satellite Organization (EUTELSAT)
FGER	France/Germany
FIN	Finland
FR	France
FRIT	France/Italy
GER	Germany
GHA	Republic of Ghana
GLOB	Globalstar
GREC	Greece
GRSA	Greece/Saudi Arabia
HUN	Hungary
IM	International Mobile Satellite Organization (INMARSAT)
IND	India
INDO	Indonesia
IRAN	Iran
IRAQ	Iraq
IRID	Iridium
ISRA	Israel
ISRO	Indian Space Research Organisation
ISS	International Space Station
IT	Italy
ITSO	International Telecommunications Satellite Organization (INTELSAT)
JPN	Japan
KAZ	Kazakhstan
KEN	Republic of Kenya
LAOS	Laos
LTU	Lithuania
LUXE	Luxembourg
MA	Morroco
MALA	Malaysia
MEX	Mexico
MNG	Mongolia
NATO	North Atlantic Treaty Organization
NEP	Federal Democratic Republic of Nepal
NETH	Netherlands
NICO	New ICO
NIG	Nigeria
NKOR	Democratic People's Republic of Korea
NOR	Norway
NZ	New Zealand
O3B	O3b Networks
ORB	ORBCOMM
PAKI	Pakistan
PERU	Peru
POL	Poland
POR	Portugal
PRC	People's Republic of China
PRES	People's Republic of China/European Space Agency
QATR	State of Qatar
RASC	RascomStar-QAF
ROC	Taiwan (Republic of China)
ROM	Romania
RP	Philippines (Republic of the Philippines)
RWA	Republic of Rwanda
SAFR	South Africa
SAUD	Saudi Arabia
SDN	Republic of Sudan
SEAL	Sea Launch
SES	SES
SGJP	Singapore/Japan
SING	Singapore
SKOR	Republic of Korea
SPN	Spain
SRI	Democratic Socialist Republic of Sri Lanka
STCT	Singapore/Taiwan
SWED	Sweden
SWTZ	Switzerland
THAI	Thailand
TMMC	Turkmenistan/Monaco
TURK	Turkey
UAE	United Arab Emirates
UK	United Kingdom
UKR	Ukraine
UNK	Unknown
URY	Uruguay
US	United States
USBZ	United States/Brazil
VENZ	Venezuela
VTNM	Vietnam